111111111111
10P000000001
10C0C0C0C0E1
111111111111