1111111111111111111111111
1PE00C000C000000000000001
1011110111111111111101101
1C0000010000000000C000001
1011100110111111111111101
1C00100000C00000000000101
1010111111111111111100101
1C00000000000000000000101
1011111111110111111111101
100000C00000010000C000001
1111111111110111111111101
1C0000000000C00000000CC01
1011111111111111111111101
1C00000C00000000000000001
1111111111111111111111111