111111111111111111111111111111111111111111111111111111111111111111111111111111111111111111111111111111
1P0000000000000000000000000000000000000000000000C00000000000000000000000000000000000000000000000000001
101111111111111111111111111111111111111111111101111111111111111111111111111111111111111111111111110101
100000000000000000000000000000000000000000000001000000000000000000000000000000000000000000000000000C01
101111111111111111111111111111111111111111111101111111111111111111111111111111111111111111111111110101
100000000000000000000000000000000000000000000001000000000000000000000000000000000000000000000000000001
101111111111111111111111111111111111111111111101111111111111111111111111111111111111111111111111110101
10000000000000000000000000000000000000000000000100000000000000000000000000000000000000000000000000C001
101111111111111111111111111111111111111111111101111111111111111111111111111111111111111111111111110101
100000000000000000000000000000000000000000000001000000000000000000000000000000000000000000000000000001
101111111111111111111111111111111111111111111101111111111111111111111111111111111111111111111111110101
1C0000000000000000000000000000000000000000000000000000000000000000000000000000000000000000000000000001
101111111111111111111111111111111111111111111111111111111111111111111111111111111111111111111111110101
10000000000000000000000000000000000000000000000000000000000000000000000000000000000000000000000000C001
101111111111111111111111111111111111111111111101111111111111111111111111111111111111111111111111110101
100000000000000000000000000000000000000000000001000000000000000000000000000000000000000000000000000001
101111111111111111111111111111111111111111111101111111111111111111111111111111111111111111111111110101
10000000000000000000000000000000000000000000000100000000000000000000000000000000000000000000000000C001
101111111111111111111111111111111111111111111101111111111111111111111111111111111111111111111111110101
1C0000000000000000000000000000000000000000000000000000000000000000000000000000000000000000000000000E01
111111111111111111111111111111111111111111111111111111111111111111111111111111111111111111111111111111
