1111111111
1P0CCCECC1
1111111111