111111111111
10P0000C0001
10C0C0C010E1
100C0C0C10C1
111111111111