111111111111
1P0000000001
100000000001
100000C000E1
111111111111